WALLS_SPRITE_PACK
walls
OBJECTS_SPRITE_PACK
objects
ENEMY_SPRITE_PACK_0
soldier1
ENEMY_SPRITE_PACK_1
soldier2

OPEN_DOOR
4
16
CLOSED_DOOR
2
16
LOCKED_DOOR_TYPE_0
2
17
LOCKED_DOOR_TYPE_1
3
17
TREASURE_OBJECT_TYPE_0
1
6
TREASURE_OBJECT_TYPE_1
2
6
TREASURE_OBJECT_TYPE_2
3
6
TREASURE_OBJECT_TYPE_3
4
6
KEY_OBJECT_TYPE_0
2
4
KEY_OBJECT_TYPE_1
3
4


# red,green,blue
CEIL_COLOR
483818

FLOOR_COLOR
6A6A6A

# may be defined out of order
# the argument is the (x,y) coords of the subsprite of the respective
# sprite pack (wall textures or objects)
WALL_TYPE_1
2
11
WALL_TYPE_2
4
12
WALL_TYPE_3
0
14
WALL_TYPE_4
0
12
WALL_TYPE_5
1
17
WALL_TYPE_6
0
0
WALL_TYPE_7
2
2
WALL_TYPE_0
2
1

FURNITURE_OBJECT_TYPE_1
4
0
FURNITURE_OBJECT_TYPE_2
4
1

# do NOT generate manually; use the map editor instead
LAYOUT
11111111111111111111111111111111111
1.................................1
1.................................1
1.................................1
1.................................1
1......113141311..................1
1.....11.......11..77077..........1
1.....1.........1..7...7..........1
1.....2.........2177...0..........1
1.....f..........d.....7..........1
1.....1.........1177...7..........1
1.....g.........3..7...0..........1
1.....2....7....2..7...7..........1
1.....1.........1..7...7..........1
1.....d.........4..7...0..........1
1.....1.........1..7...7..........1
1.....2....7....2..7...7..........1
1.....1.........1..77d70..........1
1.....1.........11177.77..........1
1.....1..1.1.......11121.111......1
1.....2..................d.1......1
1.....1..........12112112111......1
1.....11.......111................1
1......115121111..................1
1.................................1
1.................................1
1.................................1
1.................................1
1.................................1
11111111111111111111111111111111111
OBJECTS
...................................
...................................
...................................
...................................
...................................
...................................
........a..........................
....................ttt............
............21.....................
...........a1.....s................
............1......................
.l.................................
......................k............
...................................
...................................
...................................
...................................
...................................
.....................e.............
..........a........................
..........................e........
........t...u.i.a..................
...................................
...................................
...................................
...................................
...................................
...................................
...................................
...................................

PLAYER_START_ANGLE
-90
